0000000000
0350000350
0350000350
0351111350
0000000000
0351111350
0350000350
0350000350
0350000350
0000000000
