0000000000
0350000350
0350000350
0350000350
0001111000
0350000350
0350000350
0350000350
0350000350
0000000000
