00000000000000000000
00111111000010000100
00000000000010000100
00111111000010000100
00100001000010000100
00100001000010000100
00100001000010000100
00100001000010000100
00133331222213333100
00100001000010000100
00000000000000000100
00100001000010000100
00100001000010000100
00100001000010000100
00100001000010000100
00100001000010000100
00122221000012222100
00100001000010000100
00100001000010000100
00000000000000000000
