0000000000
0350000000
0350000000
0350000000
0350000000
0350000000
0350000000
0350000790
0350000790
0000000000
